marital status - stan cywilny
occupation - zawód
racial group / ethnic group - grupa etniczna
spouse - współmałżonek
muscular - muskularny
obese - otyły
plump - pulchny
skinny / thin - chudy
slender / slim - szczupły
stocky - krępy
curly -  kręcone
fringe - grzywka
frizzy - kędzierzawe
highlights - pasemka
plait - warkocz
tied in a bun - zebrane w kok
dimple - dołek
freckles - piegi
mole / beauty spot - pieprzyk
piercing - kolczyk
wrinkles - zmarszczki
cape cardigan - luźny sweter / rozpinany sweter
dressing gown - szlafrok
jersey - sweter / koszulka sportowa
sleeve - rękaw
sweatshirt - bluza
high heels - buty na wysokim obcasie
slippers - kapcie
fold - złożyć
shrink - skurczyć się
stretch - rozciągnąć się
undo the buttons - rozpiąć guziki
baggy - workowaty
casual - nieformalny
creased - wygnieciony
faded - wypłowiały
feminine - kobiecy
floaty - zwiewny
floral - w kwiaty
flowy - spływający swobodnie
loose / loose fitting - luźny
ripped - podarty z dziurami
scruffy - niechlujny
shabby - zaniedbany
sleeveless - bez rękawów
smart / elegant - elegancki
stretchy - rozciągliwy / elastyczny
striped - w paski
stylish - stylowy
tight / tight fitting - ciasny
trendy - modny
unique - unikalny
vintage - vintage / staromodny
blend into the crowd - wmieszać się w tłum
conform to a style - dopasować się do stylu
express sb's individuality - być wyrazem czyjejś indywidualności
switch allegiance - zmienić przynależność
glance - rzucić okiem
glare - wpatrywać się ze złością
glimpse - spojrzeć przelotnie
inspect / scrutinise - zlustrować
peek - zerkać
peer - przyglądać się
hiss - syczeć
moan - jęczeć / narzekać
mumble / mutter - mamrotać
shout - krzyczeć
stutter - jękać się
whisper - szeptać
yell - wrzeszczeć
bang your fist - uderzyć pięścią
fold your arms - skrzyżować ramiona
frown - zmarszczyć brwi
gesture - gest
hands on hips - ręce na biodrach
have your elbows on the table - opierać się łokciami o stół
hide your face in your hands - ukryć twarz w dłoniach
lean back - odchylać się / opierać się / rozpierać się
posture - postawa
purse your lips - zacisnąć usta
raise your eyebrows - unieść brwi ze zdumienia
shake your head - potrząsnąć głową
shrug your shoulders - wzruszyć ramionami
stand with your feet apart - stać na szeroko rozstawionych nogach
tap your fingers - bębnić palcami
tremble - drzeć / trząść się
turn to somebody - odwrócić się do kogoś
wink - mrugnąć
absent minded - roztargniony
argumentative - kłótliwy
arrogant - arogancki
bossy - dominujący / apodyktyczny
bright - bystry / rozgarnięty
broad minded - o szerokich horyzontach
busybody - osoba wścibska
caring - troskliwy
conceited - zarozumiały
conscientous - sumienny
cynical - cyniczny
honest - uczciwy
dishonest - nieuczciwy
dull - nudny
entertaining - zabawny / wesoły
flexible - elastyczny
generous - hojny
gullible - łatwowierny
humble - skromny
mature - dojrzały
immature - niedojrzały
modest - skromy
immodest - nieskromny
discreet - dyskretny
indiscreet - niedyskretny
efficient - sprawny
inefficient - niesprawny
sincere - szczery
insincere - nieszczery
mean - skąpy / złośliwy
messy - nieporządny
narrow minded - o wąskich horyzontach
nosy - wścibski
partial - stronniczy
impartial - bezstronny
procrastinator - osoba która wszystko odkłada na później
rebellious - buntowniczy
reserved - powściągliwy
self centred - egocentryczny
self confident / self assured - pewny siebie